56,59,52,384,594,556,817,654,1946,9,65,97
57,55,58,360,635,498,804,696,2056,9,65,97
57,60,58,354,595,555,819,943,2103,9,65,97
55,59,60,338,623,540,820,790,1919,9,65,97
56,60,55,381,635,541,811,972,1898,9,65,97
58,49,55,358,636,532,831,744,1918,9,65,97
59,60,48,386,554,556,811,864,2036,9,65,97
55,64,45,393,624,535,812,799,1987,9,65,97
59,48,54,373,635,541,811,746,1892,9,65,97
58,55,49,396,595,556,788,627,2007,9,65,97
58,55,54,379,600,553,811,728,2102,9,65,97
56,62,57,375,628,541,804,801,1899,9,65,97
62,65,60,371,635,551,821,920,1943,9,65,97
61,57,51,375,635,531,797,796,2031,9,65,97
58,53,61,388,629,507,794,747,1876,9,65,97
57,55,59,374,635,551,831,711,2079,9,65,97
54,56,55,335,635,551,812,724,1944,9,65,97
58,54,49,367,635,489,793,869,2035,9,65,97
60,59,52,385,600,557,800,829,1976,9,65,97
56,57,57,395,630,551,830,601,2009,9,65,97
63,70,53,398,629,535,830,831,1918,9,65,97
52,58,54,362,611,555,817,843,2035,9,65,97
57,69,52,383,635,526,783,745,1941,9,65,97
56,60,59,371,624,535,829,802,2029,9,65,97
58,55,54,352,623,541,777,755,1915,9,65,97
57,54,53,320,618,530,836,806,1938,9,65,97
60,54,44,356,607,473,841,751,1984,9,65,97
59,59,56,362,591,506,875,904,2015,9,65,97
59,63,58,353,622,524,902,781,1974,9,65,97
61,61,55,345,620,520,926,889,1850,9,65,97
56,55,54,356,586,617,881,828,1921,9,65,97
54,65,62,347,529,661,936,823,1785,9,65,97
53,67,62,368,553,695,917,811,1527,9,65,97
58,57,58,365,542,715,924,821,1668,9,65,97
54,54,57,355,500,727,888,732,1601,9,65,97
60,51,56,281,585,695,903,889,1311,9,65,97
60,66,55,240,640,739,929,926,1216,9,65,97
62,57,62,225,626,753,872,752,1342,9,65,97
56,54,54,292,627,759,926,784,1378,9,65,97
55,66,58,323,575,758,908,684,1454,9,65,97
58,63,56,346,645,713,882,734,1517,9,65,97
54,58,56,325,640,761,904,899,1566,9,65,97
61,59,56,368,634,749,907,743,1349,9,65,97
61,69,55,374,676,756,887,990,1492,9,65,97
63,56,57,372,678,749,913,785,1421,9,65,97
59,52,57,370,687,758,910,761,1308,9,65,97
57,57,59,336,687,751,936,687,1443,9,65,97
53,55,57,319,687,721,927,831,1349,9,65,97
61,58,61,353,654,765,919,734,1348,9,65,97
59,60,59,367,676,758,903,995,1362,9,65,97
59,51,59,362,687,729,909,908,1316,9,65,97
60,51,56,373,675,737,928,886,1448,9,65,97
62,59,57,348,655,705,894,834,1397,9,65,97
58,64,54,367,668,719,888,695,1359,9,65,97
56,56,49,366,662,766,890,874,1338,9,65,97
55,65,60,322,654,766,908,819,1499,9,65,97
58,64,58,371,668,766,914,861,1350,9,65,97
57,53,56,348,648,758,936,961,1312,9,65,97
55,49,58,372,674,766,890,812,1369,9,65,97
54,60,49,368,656,764,927,740,1349,9,65,97
56,59,58,370,655,763,907,912,1559,9,65,97
62,63,58,348,673,755,913,812,1578,9,65,97
59,58,57,349,639,754,904,711,1450,9,65,97
53,54,55,353,651,754,862,731,1553,9,65,97
62,60,58,354,660,780,956,749,1381,9,65,98
62,58,59,367,656,795,1014,832,1284,9,66,99
51,59,59,335,747,823,1081,887,1193,9,67,101
58,56,58,370,745,900,1109,883,1100,9,69,104
58,51,56,396,758,1009,1439,1034,1130,9,70,105
58,61,55,409,820,1080,1609,770,1196,9,72,107
60,63,57,423,913,1242,1691,496,1445,9,65,97
54,57,51,443,972,1436,1626,574,1944,9,66,98
54,59,58,453,995,1637,1299,473,1836,9,67,100
61,60,52,463,1095,1880,1261,741,1458,9,68,101
62,63,57,475,1244,1857,1230,823,987,9,70,104
60,58,47,508,1449,1872,1284,1265,468,9,71,106
60,59,55,476,1640,1697,1281,1312,403,9,72,107
56,46,52,581,1813,1554,1440,1211,377,9,65,97
60,68,61,550,1913,1586,1867,607,352,9,66,99
53,56,57,674,1969,1491,1866,376,346,9,67,100
56,55,53,752,1786,1623,1462,411,332,9,68,102
59,68,59,828,1679,1700,1370,380,319,9,70,104
63,55,58,796,1651,1690,1055,378,330,9,70,104
56,50,64,789,1664,1697,1257,376,335,9,70,104
61,59,61,653,1671,1609,1244,376,332,9,70,104
62,56,58,742,1641,1736,1270,369,328,9,70,104
58,56,52,789,1637,1668,1210,366,319,9,70,104
54,57,53,824,1615,1645,1102,363,309,9,70,104
60,56,59,796,1604,1780,915,327,296,9,70,105
60,64,51,774,1555,1682,699,310,227,9,70,105
61,60,53,802,1615,1715,370,270,226,9,70,105
58,58,59,649,1572,1548,324,234,199,9,70,105
62,57,49,689,1545,1223,273,196,170,9,70,105
48,57,51,706,1535,1049,248,169,149,9,70,105
57,61,53,761,1533,1108,234,153,140,9,70,105
54,58,58,725,1523,1003,220,148,129,9,70,104
61,61,57,686,1510,985,212,142,125,9,70,104
58,57,55,730,1534,931,206,148,128,9,70,104
61,51,56,749,1524,937,211,143,126,9,70,104
60,64,50,755,1529,992,209,145,114,9,70,104
59,50,53,632,1567,939,204,144,124,9,70,105
57,54,53,643,1598,570,193,138,124,9,71,106
54,54,60,626,1549,285,172,134,127,9,72,108
61,61,58,666,1195,248,160,134,125,9,65,98
56,57,52,662,964,219,155,140,127,9,66,99
54,58,51,620,651,196,149,139,138,9,68,102
52,60,48,731,285,194,143,140,145,9,69,104
57,60,50,354,302,186,159,155,158,9,70,105
60,59,56,200,268,174,154,154,174,9,71,107
61,57,54,193,234,174,162,166,182,9,65,97
63,57,55,182,223,179,171,180,207,9,66,98
59,57,55,165,220,171,178,188,223,9,67,100
59,67,58,163,207,179,191,200,257,9,69,103
61,60,56,147,211,186,195,219,301,9,70,104
58,57,53,150,210,200,201,249,348,9,71,106
61,54,57,136,217,205,216,270,437,9,72,107
52,63,62,140,222,202,238,301,544,9,65,97
59,57,55,127,216,220,255,337,666,9,66,98
57,55,53,137,214,233,277,382,1113,9,67,100
63,53,53,139,239,243,306,473,1851,9,69,103
58,65,49,142,244,261,327,539,2947,9,69,104
55,47,61,147,236,240,340,550,3128,9,69,104
58,53,51,148,238,255,309,542,3129,9,69,104
60,60,54,144,231,256,328,543,3047,9,69,104
58,57,48,139,242,257,315,527,2856,9,69,104
63,60,57,141,238,259,327,521,2974,9,69,104
54,56,52,149,240,262,325,540,3168,9,69,104
58,59,51,147,214,246,341,553,2975,9,69,104
54,53,47,136,241,263,330,537,3057,9,69,104
55,63,59,137,243,256,350,564,3553,9,70,104
60,60,55,146,249,269,360,605,3827,9,70,105
58,66,59,151,248,272,363,623,3728,9,70,105
59,62,61,152,247,268,347,628,3530,9,70,105
57,62,53,143,243,267,356,611,3769,9,70,105
58,54,59,151,242,274,351,603,3772,9,70,105
58,67,45,150,252,280,363,610,3804,9,70,105
60,58,58,160,258,281,370,626,3807,9,70,105
56,64,58,158,259,288,376,635,3914,9,70,105
55,59,61,165,267,296,386,628,3686,9,70,105
51,61,57,161,265,295,381,624,3532,9,70,105
58,52,56,167,258,297,388,618,3557,9,70,105
61,63,59,163,273,297,385,616,3658,9,70,105
63,61,59,165,274,302,398,543,3718,9,70,105
53,55,52,168,271,308,396,580,3690,9,70,105
55,67,59,154,285,302,412,624,3606,9,70,105
56,50,54,165,252,303,411,699,3560,9,70,105
58,59,58,169,282,320,404,780,3673,9,70,105
56,60,50,164,293,329,428,986,3878,9,71,106
61,57,60,179,301,338,457,1024,3888,9,71,107
55,53,50,189,301,353,501,1216,4100,9,72,108
56,69,51,189,325,387,563,1762,3650,9,65,97
57,58,57,174,330,429,893,2367,3211,9,66,98
49,54,53,199,358,468,1287,2180,2641,9,68,101
55,66,53,202,353,534,1766,2929,1978,9,69,103
55,69,50,179,399,556,2231,2679,1401,9,69,104
58,64,57,208,417,596,2601,2581,1444,9,70,104
57,68,52,204,415,595,2460,2909,1292,9,70,104
53,65,60,207,426,847,3133,2237,1189,9,71,107
57,52,53,217,465,1279,3144,2195,1015,9,72,107
59,55,57,226,476,1380,3216,1900,908,9,72,107
62,62,56,224,471,1311,3217,2169,945,9,72,107
60,60,64,222,423,1302,3395,2117,1043,9,72,107
58,65,53,229,470,1477,3320,1679,920,9,72,108
59,55,50,224,517,1641,3449,1918,943,9,72,108
61,57,53,239,536,1846,3478,1551,882,9,72,108
61,62,54,262,569,1975,3505,1501,810,9,72,108
60,55,53,261,599,2147,3671,1473,802,9,72,108
60,60,56,269,596,2022,3685,1666,769,9,72,108
57,58,48,263,594,1953,3477,1817,775,9,71,107
59,64,60,255,562,1800,3405,2229,834,9,71,106
56,58,54,269,548,1444,2707,2396,1110,9,70,104
60,56,56,256,511,900,2620,2873,1348,9,69,103
54,56,50,255,475,620,2287,2694,1877,9,68,101
57,58,59,247,434,538,1587,2371,2461,9,67,100
58,56,53,245,430,514,1226,1715,3278,9,66,98
61,61,56,232,419,475,1044,1617,3615,9,65,97
55,52,51,228,407,446,551,1454,3613,9,70,105
59,60,54,218,396,433,537,1019,3629,9,69,104
60,58,59,232,388,406,479,965,3026,9,68,102
60,61,53,226,383,391,451,593,2475,9,67,101
51,55,57,231,372,378,422,532,2270,9,66,99
52,57,56,229,372,376,396,517,1960,9,65,98
55,55,58,243,382,367,368,469,1627,9,72,108
60,65,64,245,379,346,356,439,1019,9,71,107
51,64,56,257,388,351,348,398,543,9,69,104
53,63,54,260,401,348,339,367,484,9,68,102
56,52,56,281,432,350,335,364,437,9,67,100
58,67,52,286,450,350,323,333,396,9,66,99
61,57,48,340,478,361,327,331,387,9,65,98
57,55,53,354,517,375,322,314,355,9,72,108
58,50,56,592,602,383,323,310,319,9,71,106
57,63,55,832,669,415,325,303,308,9,69,103
52,71,59,845,1042,436,328,299,295,9,68,102
55,54,54,752,1424,484,338,304,288,9,67,100
57,60,56,687,1692,531,361,303,293,9,66,99
54,65,48,848,2023,607,366,303,275,9,65,97
59,53,61,898,2091,835,402,309,284,9,72,108
56,61,62,931,2050,1270,457,327,282,9,71,106
59,59,55,750,2212,1576,501,354,286,9,70,104
56,51,53,507,2373,1905,567,381,296,9,68,101
56,63,57,315,2189,2001,762,402,305,9,67,100
56,55,54,325,1729,2018,1160,440,326,9,66,98
57,61,58,350,1366,2236,1451,500,341,9,65,97
57,56,63,373,954,2249,1522,552,382,9,72,107
54,60,50,264,761,2310,1906,739,395,9,71,106
59,65,57,373,651,2151,1720,859,434,9,70,104
54,65,56,299,753,1841,1920,1098,495,9,68,102
60,60,55,358,594,1491,1903,1269,564,9,66,99
58,59,59,382,430,1233,1916,1070,592,9,66,98
55,62,62,184,658,1319,2043,1007,937,9,65,97
60,60,57,398,663,1166,1787,1139,1304,9,71,107
60,61,57,407,676,1017,1704,1121,1605,9,70,105
55,54,51,414,674,747,1200,1147,1964,9,69,104
55,51,54,398,740,730,1101,1254,1870,9,68,102
52,65,54,418,715,643,1065,990,1554,9,67,101
60,69,60,418,704,620,976,673,2014,9,65,98
58,55,55,393,723,674,840,688,2010,9,65,97
56,63,50,402,746,669,806,600,2138,9,65,97
58,57,61,416,716,672,817,686,2090,9,65,97
57,56,55,431,726,691,823,667,2105,9,65,97
55,67,59,422,738,686,824,680,2097,9,65,97
56,52,56,404,701,670,819,808,2144,9,65,97
60,55,58,417,733,636,835,722,2011,9,72,108
55,53,56,416,708,616,881,655,1951,9,72,108
59,52,62,423,701,582,914,748,1926,9,72,108
59,59,61,412,685,580,920,685,2077,9,72,108
58,54,53,389,679,581,943,688,1857,9,72,108
57,60,54,382,665,646,953,778,1882,9,72,108
61,54,57,383,657,664,940,812,1887,9,65,97
59,60,59,380,623,737,970,814,1860,9,65,97
52,59,52,388,628,744,962,881,1705,9,65,97
59,61,60,339,624,757,973,663,1579,9,65,97
55,58,47,389,603,770,962,883,1552,9,65,97
55,63,60,357,630,759,948,734,1492,9,65,97
55,64,60,322,647,757,973,753,1749,9,65,97
56,55,52,266,658,802,926,732,1229,9,65,97
58,57,54,249,705,787,971,626,1375,9,65,97
61,65,55,302,699,792,934,695,1434,9,72,108
50,58,50,308,704,792,953,738,1526,9,72,108
57,60,57,286,700,774,897,799,1305,9,72,107
52,61,49,271,648,735,863,917,1539,9,71,106
60,61,56,274,632,708,825,914,1427,9,69,104
59,53,53,344,564,677,800,963,1578,9,68,102
54,64,55,383,518,662,744,886,1423,9,67,101
55,61,53,410,552,662,727,878,1229,9,66,99
59,58,52,426,598,596,687,840,1088,9,65,98
59,53,56,480,728,547,652,788,999,9,72,108
63,62,59,505,841,508,610,735,906,9,71,106
58,57,54,495,877,475,636,735,901,9,71,106
61,56,64,515,882,480,619,730,896,9,71,106
59,58,53,538,893,494,617,736,898,9,71,106
54,59,50,505,908,481,641,733,927,9,71,106
53,55,59,498,879,465,629,730,885,9,71,106
60,50,49,462,884,471,629,742,903,9,71,106
58,61,57,520,864,487,612,736,900,9,71,106
54,59,53,512,902,473,614,728,906,9,71,106
55,53,57,505,796,525,645,747,945,9,71,106
58,56,53,453,673,580,666,766,994,9,72,108
57,59,59,460,566,637,693,812,1102,9,65,97
56,62,55,410,520,640,739,878,1184,9,66,99
55,52,60,369,557,659,765,945,1437,9,68,102
57,62,55,314,576,717,777,976,1568,9,69,104
60,55,61,277,579,740,827,933,1652,9,70,105
60,52,56,285,675,774,875,857,1408,9,71,106
61,56,58,341,701,794,959,730,1482,9,72,108
61,57,53,350,737,805,1024,597,1505,9,65,98
59,56,56,387,755,870,1070,578,1258,9,66,99
59,60,59,385,750,945,1100,513,1212,9,68,102
58,61,59,375,830,991,1156,674,1015,9,69,103
60,53,53,393,821,992,1212,899,1166,9,69,103
57,65,47,384,805,970,1067,1013,1017,9,69,103
63,58,60,376,821,946,1108,968,1030,9,69,103
59,62,61,376,821,955,1179,932,1207,9,69,103
62,63,57,400,807,967,1112,852,1085,9,69,103
58,56,55,392,821,972,1107,849,907,9,69,103
63,58,55,391,789,932,1180,891,982,9,67,101
57,56,58,381,743,866,1087,901,1170,9,66,99
61,62,54,343,726,794,1022,584,1304,9,65,98
60,66,49,314,709,791,943,853,1414,9,65,97
56,58,52,332,701,790,959,738,1418,9,72,108
58,56,60,340,683,766,932,809,1483,9,72,108
57,61,56,347,702,765,965,749,1522,9,72,108
57,57,53,339,694,762,923,732,1509,9,72,108
58,60,52,343,715,768,951,698,1423,9,72,108
61,54,54,341,694,795,976,804,1460,9,72,108
59,60,53,331,674,810,948,962,1298,9,72,108
55,60,60,335,702,804,957,676,1642,9,72,108
60,60,56,341,694,765,976,635,1502,9,72,108
59,68,56,345,702,811,953,895,1516,9,72,108
59,65,51,332,714,804,921,782,1451,9,72,108
58,56,54,344,687,754,926,831,1436,9,72,108
59,54,57,343,673,811,968,808,1465,9,72,108
59,59,46,342,625,811,927,771,1560,9,72,108
53,63,55,341,671,812,933,650,1474,9,72,108
61,53,51,328,708,767,938,736,1395,9,72,108
54,54,62,332,688,747,953,736,1566,9,72,108
63,63,56,302,716,776,950,771,1494,9,72,108
62,68,50,338,670,811,928,652,1450,9,72,108
53,62,53,338,675,812,932,762,1492,9,72,108
