1015 514 361 282 264 174 57 71 59 1
26 65 495 1866 1895 399 59 65 45 12
2856 527 315 257 242 139 48 57 58 9
2943 764 1220 1349 1524 516 56 61 57 18
1658 956 695 682 1736 1134 56 55 62 7
947 1196 2551 1477 1036 478 53 60 56 17
400 926 3108 1997 1868 364 54 66 50 19
422 310 416 517 461 276 51 62 60 24
2134 648 442 371 341 173 59 47 50 12
724 821 1475 2393 2030 722 50 63 44 21
49 421 1648 1879 867 336 52 61 50 12
1091 1249 2997 445 423 197 59 52 58 10
848 1012 795 640 621 365 58 54 57 10
1141 655 375 305 298 204 44 58 57 2
616 1085 1010 327 522 279 52 65 57 24
1636 1803 1418 1387 1408 511 52 62 58 18
1703 1014 526 455 434 271 48 62 60 7
482 414 710 1026 834 378 58 51 58 10
2968 789 1913 1694 2492 1057 55 60 55 22
86 99 158 331 244 168 59 63 55 3
1640 601 536 407 421 241 53 62 55 20
1519 703 2196 2890 1554 243 55 64 50 13
91 102 159 316 256 179 58 60 62 3
296 358 332 333 755 1120 56 72 59 1
1972 1385 1288 2215 2402 601 60 64 50 20
1662 1031 549 467 438 269 52 63 58 7
371 233 214 221 268 222 58 63 50 2
362 399 427 568 1367 705 53 58 55 20
567 1111 1243 323 479 271 55 65 52 24
1473 1648 2944 1428 850 758 52 64 53 14
385 165 183 1400 1482 130 55 68 59 16
463 767 1559 1334 2124 1116 55 60 57 6
1940 356 352 338 390 227 52 63 53 10
1155 884 1168 1116 1620 861 49 68 60 23
79 79 80 157 539 600 54 70 58 3
709 815 2715 2551 1402 355 51 63 55 7
516 452 465 561 780 442 52 54 57 17
1719 2223 2203 1816 322 273 56 60 49 13
2967 787 2055 1776 2387 987 51 63 53 22
128 128 159 590 1704 1108 55 53 59 13
850 809 1101 1258 1472 663 59 64 52 23
1351 878 1308 786 383 298 42 61 53 18
1111 603 512 806 2756 944 50 62 49 16
294 299 1705 1821 1568 619 52 58 54 18
1042 1875 2925 2069 1818 557 54 67 56 24
971 481 332 280 1967 1149 61 62 57 1
915 1082 1528 1774 1691 322 58 62 50 21
843 872 1128 1469 1773 965 55 62 59 14
1726 356 1784 2665 1703 498 54 62 58 6
2830 1275 738 900 1132 507 52 60 52 2
