59 71 57 174 264 282 361 514 1015 1 8 12
45 65 59 399 1895 1866 495 65 26 12 90 134
58 57 48 139 242 257 315 527 2856 9 69 104
57 61 56 516 1524 1349 1220 764 2943 18 139 208
62 55 56 1134 1736 682 695 956 1658 7 50 75
56 60 53 478 1036 1477 2551 1196 947 17 130 194
50 66 54 364 1868 1997 3108 926 400 19 147 220
60 62 51 276 461 517 416 310 422 24 192 288
50 47 59 173 341 371 442 648 2134 12 96 144
44 63 50 722 2030 2393 1475 821 724 21 161 241
50 61 52 336 867 1879 1648 421 49 12 94 140
58 52 59 197 423 445 2997 1249 1091 10 78 116
57 54 58 365 621 640 795 1012 848 10 80 120
57 58 44 204 298 305 375 655 1141 2 16 24
57 65 52 279 522 327 1010 1085 616 24 190 285
58 62 52 511 1408 1387 1418 1803 1636 18 143 214
60 62 48 271 434 455 526 1014 1703 7 56 84
58 51 58 378 834 1026 710 414 482 10 73 109
55 60 55 1057 2492 1694 1913 789 2968 22 173 259
55 63 59 168 244 331 158 99 86 3 24 36
55 62 53 241 421 407 536 601 1640 20 159 239
50 64 55 243 1554 2890 2196 703 1519 13 104 156
62 60 58 179 256 316 159 102 91 3 24 36
59 72 56 1120 755 333 332 358 296 1 4 5
50 64 60 601 2402 2215 1288 1385 1972 20 153 229
58 63 52 269 438 467 549 1031 1662 7 56 84
50 63 58 222 268 221 214 233 371 2 16 24
55 58 53 705 1367 568 427 399 362 20 154 230
52 65 55 271 479 323 1243 1111 567 24 190 285
53 64 52 758 850 1428 2944 1648 1473 14 106 159
59 68 55 130 1482 1400 183 165 385 16 126 189
57 60 55 1116 2124 1334 1559 767 463 6 44 66
53 63 52 227 390 338 352 356 1940 10 76 114
60 68 49 861 1620 1116 1168 884 1155 23 177 265
58 70 54 600 539 157 80 79 79 3 20 30
55 63 51 355 1402 2551 2715 815 709 7 55 82
57 54 52 442 780 561 465 452 516 17 134 201
49 60 56 273 322 1816 2203 2223 1719 13 97 145
53 63 51 987 2387 1776 2055 787 2967 22 173 259
59 53 55 1108 1704 590 159 128 128 13 100 150
52 64 59 663 1472 1258 1101 809 850 23 184 275
53 61 42 298 383 786 1308 878 1351 18 142 213
49 62 50 944 2756 806 512 603 1111 16 128 191
54 58 52 619 1568 1821 1705 299 294 18 140 210
56 67 54 557 1818 2069 2925 1875 1042 24 191 286
57 62 61 1149 1967 280 332 481 971 1 6 9
50 62 58 322 1691 1774 1528 1082 915 21 168 252
59 62 55 965 1773 1469 1128 872 843 14 107 161
58 62 54 498 1703 2665 1784 356 1726 6 44 66
52 60 52 507 1132 900 738 1275 2830 2 13 19
